TAM = "countries/Tamna.txt"
MGA = "countries/Mongolia.txt"
KRG = "countries/Kyrgyz.txt"
TUV = "countries/Tuva.txt"
KOD = "countries/Khoid.txt"
TUM = "countries/Tumed.txt"
ODS = "countries/Ordos.txt"
DGR = "countries/Daur.txt"
MWK = "countries/Warka.txt"
MHH = "countries/Hurha.txt"
MWJ = "countries/Woji.txt"
ULC = "countries/Ulch.txt"
ORQ = "countries/Oroqen.txt"
NGD = "countries/Negidal.txt"
ORO = "countries/Oroch.txt"
SSP = "countries/Sipsongpanna.txt"

#Japanese Daimyo
JST = "countries/Satomi.txt"
ROK = "countries/Rokkaku.txt"
KAG = "countries/KagaIkki.txt"

#Tibetan Tags
JON = "countries/Chone.txt"
PWO = "countries/Powo.txt"
CKL = "countries/Chakla.txt"
NAN = "countries/Nangchen.txt"
GIL = "countries/Gilgit.txt"
MAQ = "countries/Baltistan.txt"
LOO = "countries/Lo.txt"
LIN = "countries/Lingtsang.txt"
HOR = "countries/HorStates.txt"
LIJ = "countries/Lijiang.txt"
GLK = "countries/Golok.txt"
RAL = "countries/Ralung.txt"
QAM = "countries/Kham.txt"
HNZ = "countries/Hunza.txt"
CTR = "countries/Chitral.txt"

BUM = "countries/Bumthang.txt"
THI = "countries/Thimphu.txt"
PAO = "countries/Paro.txt"